xxxxxxxxxxxxxxxx
x              x
x  t           x
x              x
x              x
x              x
x       f      x
x              x
x              x
x          T   x
x              x
xxxxxxxxxxxxxxxx